YAGO:ABB_Group	YAGO:Switzerland
YAGO:Airbus_Group	YAGO:France
YAGO:Anglo_American_plc	YAGO:United_Kingdom
YAGO:ArcelorMittal	YAGO:Luxembourg
YAGO:AstraZeneca	YAGO:United_Kingdom
YAGO:BASF	YAGO:Germany
YAGO:BG_Group	YAGO:United_Kingdom
YAGO:BHP_Billiton	YAGO:Australia
YAGO:BMW	YAGO:Germany
YAGO:BP	YAGO:United_Kingdom
YAGO:Barrick_Gold	YAGO:Canada
YAGO:British_American_Tobacco	YAGO:United_Kingdom
YAGO:CITIC_Group	YAGO:China
YAGO:Cargill	YAGO:United_States
YAGO:AS_de_Carrefour	YAGO:France
YAGO:Chevron_Corporation	YAGO:United_States
YAGO:China_National_Offshore_Oil_Corporation	YAGO:China
YAGO:Christian_Dior	YAGO:France
YAGO:Saint_Gobain	YAGO:France
YAGO:ConocoPhillips	YAGO:United_States
YAGO:Daimler_AG	YAGO:Germany
YAGO:Deutsche_Post	YAGO:Germany
YAGO:Deutsche_Telekom	YAGO:Germany
YAGO:Diageo	YAGO:United_Kingdom
YAGO:ExxonMobil	YAGO:United_States
YAGO:Ford_Motor_Company	YAGO:United_States
YAGO:GDF_Suez	YAGO:France
YAGO:General_Electric	YAGO:United_States
YAGO:General_Motors	YAGO:United_States
YAGO:GlaxoSmithKline	YAGO:United_Kingdom
YAGO:Glencore_Xstrata	YAGO:Switzerland
YAGO:Google	YAGO:United_States
YAGO:Hutchison_Whampoa	YAGO:Hong_Kong,_China
YAGO:ITOCHU	YAGO:Japan
YAGO:Iberdrola	YAGO:Spain
YAGO:Imperial_Tobacco	YAGO:United_Kingdom
YAGO:IBM	YAGO:United_States
YAGO:Japan_Tobacco	YAGO:Japan
YAGO:Johnson_Johnson	YAGO:United_States
YAGO:Lafarge	YAGO:France
YAGO:Liberty_Global	YAGO:United_Kingdom
YAGO:Marubeni	YAGO:Japan
YAGO:Merck_KGaA	YAGO:United_States
YAGO:Microsoft	YAGO:United_States
YAGO:Mitsubishi_Corporation	YAGO:Japan
YAGO:Mitsui	YAGO:Japan
YAGO:Nissan_Motor_Company	YAGO:Japan
YAGO:Novartis	YAGO:Switzerland
YAGO:OMV	YAGO:Austria
YAGO:Pepsico	YAGO:United_States
YAGO:Petronas	YAGO:Malaysia
YAGO:Pfizer	YAGO:United_States
YAGO:Renault	YAGO:France
YAGO:Rio_Tinto_Group	YAGO:United_Kingdom
YAGO:Royal_Dutch_Shell	YAGO:United_Kingdom
YAGO:SABMiller	YAGO:United_Kingdom
YAGO:Samsung_Electronics	YAGO:Korea,_Republic_of
YAGO:Sanofi	YAGO:France
YAGO:Schlumberger	YAGO:United_States
YAGO:Sony	YAGO:Japan
YAGO:Statoil	YAGO:Norway
YAGO:Sumitomo_Corporation	YAGO:Japan
YAGO:Tesco	YAGO:United_Kingdom
YAGO:Teva_Pharmaceutical_Industries	YAGO:Israel
YAGO:Toyota	YAGO:Japan
YAGO:Unilever	YAGO:United_Kingdom
YAGO:United_Technologies_Corporation	YAGO:United_States
YAGO:Vattenfall	YAGO:Sweden
YAGO:Vodafone	YAGO:United_Kingdom
YAGO:Volkswagen_Group	YAGO:Germany
YAGO:Volvo	YAGO:Sweden
YAGO:WPP_plc	YAGO:United_Kingdom
YAGO:Walmart	YAGO:United_States
