YAGO:Al_Gore	Democrat	YAGO:Tennessee
YAGO:Arlen_Specter	Republican	YAGO:Pennsylvania
YAGO:Barbara_Boxer	Democrat	YAGO:California
YAGO:Barbara_Mikulski	Democrat	YAGO:Maryland
YAGO:Ben_Nighthorse_Campbell	Democrat	YAGO:Colorado
YAGO:Bill_Bradley	Democrat	YAGO:New_Jersey
YAGO:Bob_Dole	Republican	YAGO:Kansas
YAGO:Bob_Graham	Democrat	YAGO:Florida
YAGO:Bob_Kerrey	Democrat	YAGO:Nebraska
YAGO:Bob_Krueger	Democrat	YAGO:Texas
YAGO:Bob_Packwood	Republican	YAGO:Oregon
YAGO:Carl_Levin	Democrat	YAGO:Michigan
YAGO:Chris_Dodd	Democrat	YAGO:Connecticut
YAGO:Chuck_Grassley	Republican	YAGO:Iowa
YAGO:Chuck_Robb	Democrat	YAGO:Virgina
YAGO:Claiborne_Pell	Democrat	YAGO:Rhode_Island
YAGO:Connie_Mack	Republican	YAGO:Florida
YAGO:Conrad_Burns	Republican	YAGO:Montana
YAGO:Dale_Bumpers	Democrat	YAGO:Arkansas
YAGO:Dan_Coats	Republican	YAGO:Indiana
YAGO:Daniel_Akaka	Democrat	YAGO:Hawaii
YAGO:Daniel_Inouye	Democrat	YAGO:Hawaii
YAGO:David_Durenberger	Republican	YAGO:Minnesota
YAGO:David_Pryor	Democrat	YAGO:Arkansas
YAGO:Dennis_DeConcini	Democrat	YAGO:Arizona
YAGO:Dianne_Feinstein	Democrat	YAGO:California
YAGO:Dirk_Kempthorne	Republican	YAGO:Idaho
YAGO:Don_Nickles	Republican	YAGO:Oklahoma
YAGO:Ernest_Hollings	Democrat	YAGO:South_Carolina
YAGO:Frank_Lautenberg	Democrat	YAGO:New_Jersey
YAGO:Frank_Murkowski	Republican	YAGO:Alaska
YAGO:Fred_Thompson	Republican	YAGO:Tennessee
YAGO:Hank_Brown	Republican	YAGO:Colorado
YAGO:Harlan_Mathews	Democrat	YAGO:Tennessee
YAGO:Harris_Wofford	Democrat	YAGO:Pennsylvania
YAGO:Harry_Reid	Democrat	YAGO:Nevada
YAGO:Herb_Kohl	Democrat	YAGO:Wisconsin
YAGO:Howard_Metzenbaum	Democrat	YAGO:Ohio
YAGO:Howell_Heflin	Democrat	YAGO:Alabama
YAGO:Jay_Rockefeller	Democrat	YAGO:West_Virginia
YAGO:Jeff_Bingaman	Democrat	YAGO:New_Mexico
YAGO:Jesse_Helms	Republican	YAGO:North_Carolina
YAGO:Jim_Inhofe	Republican	YAGO:Oklahoma
YAGO:Jim_Jeffords	Republican	YAGO:Vermont
YAGO:Jim_Sasser	Democrat	YAGO:Tennessee
YAGO:Joe_Biden	Democrat	YAGO:Delaware
YAGO:Joe_Lieberman	Democrat	YAGO:Connecticut
YAGO:John_Breaux	Democrat	YAGO:Louisiana
YAGO:John_Chafee	Republican	YAGO:Rhode_Island
YAGO:John_Danforth	Republican	YAGO:Missouri
YAGO:John_Glenn	Democrat	YAGO:Ohio
YAGO:John_Kerry	Democrat	YAGO:Massachusetts
YAGO:John_McCain	Republican	YAGO:Arizona
YAGO:John_Warner	Republican	YAGO:Virgina
YAGO:Judd_Gregg	Republican	YAGO:New_Hampshire
YAGO:Kay_Bailey_Hutchison	Republican	YAGO:Texas
YAGO:Kent_Conrad	Democrat	YAGO:North_Dakota
YAGO:Kit_Bond	Republican	YAGO:Missouri
YAGO:Larry_Craig	Republican	YAGO:Idaho
YAGO:Larry_Pressler	Republican	YAGO:South_Dakota
YAGO:Lauch_Faircloth	Republican	YAGO:North_Carolina
YAGO:Malcolm_Wallop	Republican	YAGO:Wyoming
YAGO:Mark_Hatfield	Republican	YAGO:Oregon
YAGO:Max_Baucus	Democrat	YAGO:Montana
YAGO:Mitch_McConnell	Republican	YAGO:Kentucky
YAGO:Orrin_Hatch	Republican	YAGO:Utah
YAGO:Patrick_Leahy	Democrat	YAGO:Vermont
YAGO:Patty_Murray	Democrat	YAGO:Washington
YAGO:Paul_Coverdell	Republican	YAGO:Georgia
YAGO:Paul_Sarbanes	Democrat	YAGO:Maryland
YAGO:Paul_Simon	Democrat	YAGO:Illinois
YAGO:Paul_Wellstone	Democrat	YAGO:Minnesota
YAGO:Pete_Domenici	Republican	YAGO:New_Mexico
YAGO:Phil_Gramm	Republican	YAGO:Texas
YAGO:Richard_Bryan	Democrat	YAGO:Nevada
YAGO:Richard_Lugar	Republican	YAGO:Indiana
YAGO:Richard_Shelby	Republican	YAGO:Alabama
YAGO:Robert_Byrd	Democrat	YAGO:West_Virgina
YAGO:Russ_Feingold	Democrat	YAGO:Wisconsin
YAGO:Sam_Nunn	Democrat	YAGO:Georgia
YAGO:Slade_Gorton	Republican	YAGO:Washington
YAGO:Strom_Thurmond	Republican	YAGO:South_Carolina
YAGO:Ted_Kennedy	Democrat	YAGO:Massachusets
YAGO:Ted_Stevens	Republican	YAGO:Alaska
YAGO:Thad_Cochran	Republican	YAGO:Mississippi
YAGO:Tom_Daschle	Democrat	YAGO:South_Dakota
YAGO:Tom_Harkin	Democrat	YAGO:Iowa
YAGO:Trent_Lott	Republican	YAGO:Mississippi
YAGO:William_Cohen	Republican	YAGO:Maine
