YAGO:Al_Gore	YAGO:Tennessee
YAGO:Arlen_Specter	YAGO:Pennsylvania
YAGO:Barbara_Boxer	YAGO:California
YAGO:Barbara_Mikulski	YAGO:Maryland
YAGO:Ben_Nighthorse_Campbell	YAGO:Colorado
YAGO:Bill_Bradley	YAGO:New_Jersey
YAGO:Bob_Dole	YAGO:Kansas
YAGO:Bob_Graham	YAGO:Florida
YAGO:Bob_Kerrey	YAGO:Nebraska
YAGO:Bob_Krueger	YAGO:Texas
YAGO:Bob_Packwood	YAGO:Oregon
YAGO:Carl_Levin	YAGO:Michigan
YAGO:Chris_Dodd	YAGO:Connecticut
YAGO:Chuck_Grassley	YAGO:Iowa
YAGO:Chuck_Robb	YAGO:Virgina
YAGO:Claiborne_Pell	YAGO:Rhode_Island
YAGO:Connie_Mack	YAGO:Florida
YAGO:Conrad_Burns	YAGO:Montana
YAGO:Dale_Bumpers	YAGO:Arkansas
YAGO:Dan_Coats	YAGO:Indiana
YAGO:Daniel_Akaka	YAGO:Hawaii
YAGO:Daniel_Inouye	YAGO:Hawaii
YAGO:David_Durenberger	YAGO:Minnesota
YAGO:David_Pryor	YAGO:Arkansas
YAGO:Dennis_DeConcini	YAGO:Arizona
YAGO:Dianne_Feinstein	YAGO:California
YAGO:Dirk_Kempthorne	YAGO:Idaho
YAGO:Don_Nickles	YAGO:Oklahoma
YAGO:Ernest_Hollings	YAGO:South_Carolina
YAGO:Frank_Lautenberg	YAGO:New_Jersey
YAGO:Frank_Murkowski	YAGO:Alaska
YAGO:Fred_Thompson	YAGO:Tennessee
YAGO:Hank_Brown	YAGO:Colorado
YAGO:Harlan_Mathews	YAGO:Tennessee
YAGO:Harris_Wofford	YAGO:Pennsylvania
YAGO:Harry_Reid	YAGO:Nevada
YAGO:Herb_Kohl	YAGO:Wisconsin
YAGO:Howard_Metzenbaum	YAGO:Ohio
YAGO:Howell_Heflin	YAGO:Alabama
YAGO:Jay_Rockefeller	YAGO:West_Virginia
YAGO:Jeff_Bingaman	YAGO:New_Mexico
YAGO:Jesse_Helms	YAGO:North_Carolina
YAGO:Jim_Inhofe	YAGO:Oklahoma
YAGO:Jim_Jeffords	YAGO:Vermont
YAGO:Jim_Sasser	YAGO:Tennessee
YAGO:Joe_Biden	YAGO:Delaware
YAGO:Joe_Lieberman	YAGO:Connecticut
YAGO:John_Breaux	YAGO:Louisiana
YAGO:John_Chafee	YAGO:Rhode_Island
YAGO:John_Danforth	YAGO:Missouri
YAGO:John_Glenn	YAGO:Ohio
YAGO:John_Kerry	YAGO:Massachusetts
YAGO:John_McCain	YAGO:Arizona
YAGO:John_Warner	YAGO:Virgina
YAGO:Judd_Gregg	YAGO:New_Hampshire
YAGO:Kay_Bailey_Hutchison	YAGO:Texas
YAGO:Kent_Conrad	YAGO:North_Dakota
YAGO:Kit_Bond	YAGO:Missouri
YAGO:Larry_Craig	YAGO:Idaho
YAGO:Larry_Pressler	YAGO:South_Dakota
YAGO:Lauch_Faircloth	YAGO:North_Carolina
YAGO:Malcolm_Wallop	YAGO:Wyoming
YAGO:Mark_Hatfield	YAGO:Oregon
YAGO:Max_Baucus	YAGO:Montana
YAGO:Mitch_McConnell	YAGO:Kentucky
YAGO:Orrin_Hatch	YAGO:Utah
YAGO:Patrick_Leahy	YAGO:Vermont
YAGO:Patty_Murray	YAGO:Washington
YAGO:Paul_Coverdell	YAGO:Georgia
YAGO:Paul_Sarbanes	YAGO:Maryland
YAGO:Paul_Simon	YAGO:Illinois
YAGO:Paul_Wellstone	YAGO:Minnesota
YAGO:Pete_Domenici	YAGO:New_Mexico
YAGO:Phil_Gramm	YAGO:Texas
YAGO:Richard_Bryan	YAGO:Nevada
YAGO:Richard_Lugar	YAGO:Indiana
YAGO:Richard_Shelby	YAGO:Alabama
YAGO:Robert_Byrd	YAGO:West_Virgina
YAGO:Russ_Feingold	YAGO:Wisconsin
YAGO:Sam_Nunn	YAGO:Georgia
YAGO:Slade_Gorton	YAGO:Washington
YAGO:Strom_Thurmond	YAGO:South_Carolina
YAGO:Ted_Kennedy	YAGO:Massachusets
YAGO:Ted_Stevens	YAGO:Alaska
YAGO:Thad_Cochran	YAGO:Mississippi
YAGO:Tom_Daschle	YAGO:South_Dakota
YAGO:Tom_Harkin	YAGO:Iowa
YAGO:Trent_Lott	YAGO:Mississippi
YAGO:William_Cohen	YAGO:Maine
